## Информация по железу
dmidecode - информация по железу
hardinfo - позволяет снять отчеты, легкий gui
lshw 
mpstat - анализ CPU и shedduler

## Сеть
netstat - сокеты, TCP/IP, Интерфейсы
ss 
iperf - померить пропускную способность между узлами сети


## Операционная система
lttng - отладка ядра, необходимо ставить модули
strace - посмотреть системные вызовы
pidstat - информация по процессам
vmstat - отчет по виртуальной памяти
slabtop - инфо о буферах, кэшей, структур ядра

## Cофт
gdb - отладчик c/с++ кода
ldd - просмотреть используемые приложением библиотеки
ltrace - используемые библиотеки

## I/O, storage, disks
dio - инфо по чтению и записи
hddtemp
ide-smart - информация по SMART

## Multitool
sysdig - сетевые соединения, I/O, системные вызовы
perf - анализ производительности железа, софта
dstat - проц, память, сеть, (dstat -tldnpms 10)
sar - сбор, сохранение и отчет о системе

## security
lstat - проверка настроек на безопасность


## app
ngxtop - nginx монитор
