Alt-U — отмена
Alt-E — возврат действия
Ctrl-k Вырезать текущее выделение
Ctrl-u Вставить
Alt-6 Скопировать текущее выделение
Ctrl-6 Переключение режима выделения текста

Home = Ctrl-a
End = Ctrl-e
PgUp = Ctrl-y
PgDn = Ctrl-v
Курсорные клавиши = Ctrl-{f,b,n,p}
Tab = Ctrl-i
Backspace = Ctrl-h
Delete = Ctrl-d
Return = Ctrl-m
Помощь — Ctrl-g
Выход — Ctrl-x

Сохранить файл — Ctrl-o
Переключение подстветки синтаксиса — Alt-y
Перейти к следующему слову — Ctrl-Space
Перейти к предыдущему слову — Alt-Space
Перейти к началу строки — Home
Перейти к концу строки — End
Перейти к следующему параграфу — Alt-0
Перейти к предыдущему параграфу — Alt-9
Следующая страница — PgDn
Предыдущая страница — PgUp
Перейти к строке № — Ctrl-_
Перейти в конец файла — Alt-/
Перейти в начало файла — Alt-
Перейти к соответствующей скобке — Alt-]
Перемотать вниз — Alt-=
Перемотать вверх — Alt—
Переключение режима выделения текста — Ctrl-6 (Ctrl-^). Одна из немногих комбинаций, в которой и 6, и ^ однозначны (т.е. для ^ не надо нажимать shift)
Для выбора текста после включения режима выделения необходимо воспользоваться курсорными клавишами.
Скопировать текущее выделение — Alt-6 (Alt-^ или Ctrl-k Ctrl-u). Ещё одна комбинация, не требующая нажатия Shift для ^.

Вставить содержимое файла в новый буфер — Ctrl-r
Если же надо вставить содержимое файла в текущий буфер в место после курсора, то сначала надо выключить Multi-buffer mode у nano. Делается это при помощи комбинации Alt-f.
Вставить вывод команды — Ctrl-r Ctrl-x
Поиск — Ctrl-w
Найти следующее вхождение (Find Next…) — Alt-w или Ctrl-w Enter
Найти-заменить — Ctrl- или Alt-r
Помощь по поиску — Ctrl-w Ctrl-g
Выровнять по ширине текущий параграф (в котором находится курсор) — Ctrl-j
Выровнять по ширине весь документ — Alt-j