Процессы
ps - информация о процессах aux + фильтр вывода
	-efH - позволяет отображать древо зависимую структуру
pstree - дерево процессов
pgrep - поиск процессов
pkill - завершение процесса
Убить процесс от пользователя может пользователь
top - позволяет также убить процесс и задать способ 
фильтрации. Мягкое завершение работы.
free - загруженность оперативки
uptime - время и полнота загрузки. Можно посмотреть 
загрузку системы
id - просмотреть id групп
screen - управление сессиями в одном терминале открыть много сессий

fg 1 - переключиться в процесс
bg - запускает процесс в фоновом режиме
sleep - задержка исполнения
jobs - выполняющие задачи показывает

nohup - команда выполняются даже если пользователь
выходит из системы

Приоритеты процесса
-20 max  до +19 
nice - установка приоритета 
renice - установка уровня в т.ч для пользователя
сортировка процессов ps | grep
Высокие приоритеты могут ставить только админы
__________________________________

Ps использует в своей работе содержимое каталога /proc
Членство в группе proc позволяет просматривать процессы.

last - позволяет просматривать статистику использования учетных записей.

