haproxy - позволяет организовать распределение нагрузки
ratty - написанная на джава программа для админки различных тачек
drupal - система управления содержимым, админка для сайта.
puppet, chef - централизованная настройка сети и эвм
gitlab - клон github
jira - система заявок
ansible - система уращенной установки, по сети.
kubernetes - работа с docker на большом количестве хостов
core Os - линукс заточенный для работы с контейнерами. С мин функционалом.
flynn - система обработки ошибок при установке
cAdvisor - позволяет отслеживать состояния использования контейнеров docker
proxmox - система управления виртуальными машинами KVM
hashicorp vault - централизованное управление секретами
bacula - резервное копирование по сети
drbd - позволяет организовать обмен данных между raid и удаленным хостом
keepalived - позволяет организовать бесперебойну работу серверов, путем их
переключения при сбое.
sysctl - позволяет отконфигурировать ядро на лету.
named - dns-server
hadoop - пакет утилит для работы с кластером и распред. нагрузки
squid - кеширующий прокси-сервер
syslog - системный журнал
doze- приложение для энергосбережения для систем андроид.
surfraw - консольный поисковик
newsbeuter - rss reader
cobbler - система для разворачивания автоматической установки
mbox - песочница для приложений, на виртуальной фс
firejail - песочница
sandbox - своеобразный чрут
bumblebee - управление гибридной графической системой
prime - работа с гибридной графикой
xdotool&xclip - автоматизация кликов
cockpit - управление пк из браузера
speedtestcli.py - спидтест из cli
redmine - аналог трекера-заявок расширенного
bsd-mailx - mail консольный клиент
circus - программа на пинтоне позволяющаая просматривать процессы и сокеты
gunicorn - wsgi связка python http
rpython sandbox - песочница
exim - почтовый mta
flask - фреймворк для веб-приложении на питоне
liferay - корпоративный портал позволяющий объединить все прог. процессы
tox - протокол для текстовой, голосовой и видеосвязи в интернете
otrs - крутой корпоративный трекер
openshot, Lightworks - редакторы видео
ajenti - управление пк из браузера
vestaCP - управление пк, ориентированное на несложные операции
nodejs - javascript заточенные под системные операции с оборудованием
gods - github свой сервер легковесная альтернатива gitlab
lltng sysdig falco - модули ядра для трассировки и отслеживание проблем с ним
rclone - программа для синхронизации данных на клиент-сервере
jenkins - система непрервыной интеграции
fluentd - сборщик логов
kubernetes - система управления контейнерами
mitmproxy - обработка http пакетов
sharepoint - виндовое приложение для совметной работы на портале
rabbitmq - платформа для реализации сервиса сообщений
stunel4 - простая реализация тунеля с порта на порт. 
drbd - создать отказоустойчивый каталог (реплиц. на несколько дисков)
heartbeat - поднять отказоустойчивый сервис со динамич. ip
freeipa - реализация контролера учетных записей 389 directory server
imagemagick - позволяет обрабатывать изображения в консоли
ipcalc - позволяет посчитать ip - адрес
mtr - графический аналог traceroute
peerflix - позволяет просматривать раздачи торрента без полной загрузки
ttystudio - сохраняем работу в консоли в gif
peek - запись видео с рабочего стола в gif
screenkey - показывает нажимаемые клавиши
synergy - позволяет подключать kvm - к нескольким компьютерам
disper - использование нескольких мониторов
lsof - отображает какие процессы используют какие-файлы
jlogtailer - позволяет просматривать несколько файл логов в реальном времени
stressapptest - создание нагрузки для пк
neofetch - приветствие в консоли и краткая инфа о системе (archey)
ifplugd - подключение к сети при подключении сетевого кабеля
iftop - позволяет отслеживать подлючения и измерять их скорость
redis - СУБД сетевая носкул, ключ-вайлю и хранится в оперативке
radius - протокол авторизации аутентификации, сбора сведений о ресурсах
используется в билинге
cobbler - аналог kickstart
zentyal - дистрибьютив на убунте предостовляющий админку и сборку для средних
компаний
tfs - непрерываная интеграция от ms
xbacklight - управление подсветкой экрана
cpupower - управление тактовой частотой
tlp - универсальный инструмент для оптимизации электропотребления
powertop - выводит статистику по потреблению
duplicity - софт для бэкапа данных
elasticseach - представляет собой механизм поиска по данным
kibana - визуализация для elasticsearch
logstash - парсинг логов 
supurvisor - позволяет создать автозапуск самописных программ
chatops - групповой деплой сервисов
slack - корпоративный чат
stackstorm - механизм связи устройств для деплоя
bitlocker - шифрование дисков в microsoft
inotify - работа с событиями происходящими в файловой системе
plex - организация своего медиасервера
pushbullet - приложение для управление компьютером через смс
react - javascript библиотека для работы с пользовательским интерфейсом
redux - javascript приложения для создания fullstack приложения 
linkerd - прозрачный прокси
sphinx - поисковой движок для сайтов и бд
etcd - служба распределенного хранения конфигурации
confd - управелние конфигурацией из etcd
memcached - сервер кэширования серверов
dart - аналог javascript
clickhouse - интерактивная БД из яндекс.метрики
sxiv - простой просмотр изображений
runit, supervisor - запуск скриптов
flatpack, snap, appimage - приложения в контейнерах
celery - распределенная очередь заданий, используется с django
libsixel - открыть изображение или ссылку на изображение в терминале
kata_containers - последнее слово в контейнерах
nftables - замена iptables
etckeeper - git repo для конфиг файлов в etc
palemoon - форк firefox
containerd - управление контейнерами, часть docker
gVisor - управление изоляцией контейнеров в docker
fleet - распределенная система на базе systemd
calico - оверлейная сеть
flannel - оверлейная сеть
composer - пакетный менеджер для php (аналог pip)
galera - мультимастерная репликация в mysql
heapster - логирование в kube, расшираяется graphana
tectonic - проприаритарная надстройка над kuber
cadvisor - сборка логов внутри контейнера в kuber
polemarch - ansible интерфейс
bazzar - cvs от cannonical
scid - шахматный анализ, chess 
